This is playground. For tests.

[name]
Playground
[last_level]
1
[offset]
509A

[level]
1
[colour]
996600
[size]
16.26
[author]
mrk
[data]
OOOOOOOOOOOOOOOO
O}.............O
O..............O
O..............O
O..............O
O..............O
O..............O
O..............O
O..............O
O..............O
O..............O
O..............O
O......R.......O
O......!.......O
O..............O
O..............O
O..............O
O..............O
O..............O
O..............O
O..............O
O..b.b.b.......O
O..............O
O..............O
O..............O
OOOOOOOOOOOOOOOO
[additional]
1
1.1.}.0.0.2.0.0.0
[end]
